16
12
1000000D00000011
1000000D00000001
1000G22000022001
1020111100000001
1020000002220001
1020D00001110001
10200000000D0001
10200022200D0001
10000111110D0001
10000000000D0001
1000D000000D0001
1111111111111111