16
12
1000000D00000011
1000000D00000001
1000G22000032001
1000111100000001
1000000002220001
1000D00001110001
10000000000D0001
10000022200D0001
10000111110D0001
10000000000D0001
1000D000000D0001
1111111111111111