16
12
1111111111111111
1000000D00000001
1000G22000022001
1020111100300001
1020000002220001
1020D00001110001
1020000000000001
1020002220000001
10000111110D0001
10000000000D0001
1000D000000D0001
1111111111111111