16
12
1111111111111111
1000000000000001
1000022000022001
1020111100000001
1020000002220001
1020000001110001
1020000000000001
1020002220000001
1000011111000001
1000000000000001
1000000000000001
1111111111111111